25 21
0 0
12 12 12 12 12 12 12 12 12 12 12 12 12 12 12 12 12 12 12 12 12 12 12 12 12
12 16 16 16 16 16 16 16 16 16 16 16 16 16 16 16 16 16 16 16 16 16 16 16 12
12 16 16 16 16 16 16 16 16 16 16 16 16 16 16 16 16 16 16 16 16 16 16 16 12
12 16 16 16 16 16 16 16 16 16 16 16 16 16 16 16 16 16 16 16 16 16 16 16 12
12 16 16 16 16 16 16 16 16 16 16 16 16 16 16 16 16 16 16 16 16 16 16 16 12
12 16 16 23 16 16 16 23 23 23 16 23 23 23 16 23 23 23 16 23 23 23 16 16 12
12 16 16 23 16 16 16 23 16 23 16 23 16 23 16 23 16 16 16 23 16 16 16 16 12
12 16 16 23 16 16 16 23 16 23 16 23 16 23 16 23 16 16 16 23 16 16 16 16 12
12 16 16 23 16 16 16 23 16 23 16 23 16 23 16 23 16 16 16 23 16 16 16 16 12
12 16 16 23 16 16 16 23 16 23 16 23 16 23 16 23 23 23 16 23 23 23 16 16 12
12 16 16 23 16 16 16 23 16 23 16 23 16 23 16 16 16 23 16 23 16 16 16 16 12
12 16 16 23 16 16 16 23 16 23 16 23 16 23 16 16 16 23 16 23 16 16 16 16 12
12 16 16 23 16 16 16 23 16 23 16 23 16 23 16 16 16 23 16 23 16 16 16 16 12
12 16 16 23 16 16 16 23 16 23 16 23 16 23 16 16 16 23 16 23 16 16 16 16 12
12 16 16 23 16 16 16 23 16 23 16 23 16 23 16 16 16 23 16 23 16 16 16 16 12
12 16 16 23 23 23 16 23 23 23 16 23 23 23 16 23 23 23 16 23 23 23 16 16 12
12 16 16 16 16 16 16 16 16 16 16 16 16 16 16 16 16 16 16 16 16 16 16 16 12
12 16 16 16 16 16 16 16 16 16 16 16 16 16 16 16 16 16 16 16 16 16 16 16 12
12 16 16 16 16 16 16 16 16 16 16 16 16 16 16 16 16 16 16 16 16 16 16 16 12
12 16 16 16 16 16 16 16 16 16 16 16 16 16 16 16 16 16 16 16 16 16 16 16 12
12 12 12 12 12 12 12 12 12 12 12 12 12 12 12 12 12 12 12 12 12 12 12 12 12