25 21
0 0
12 12 12 12 12 12 12 12 12 12 12 12 12 12 12 12 12 12 12 12 12 12 12 12 12
12 10 10 10 10 10 10 10 10 10 10 10 10 10 10 10 10 10 10 10 10 10 10 10 12
12 10 10 10 10 10 10 10 10 10 10 10 10 10 10 10 10 10 10 10 10 10 10 10 12
12 10 10 10 10 12 12 10 10 10 10 10 10 10 10 10 10 10 10 10 10 10 10 10 12
12 10 10 10 10 12 12 10 10 10 10 10 10 10 10 10 10 10 10 10 10 10 10 10 12
12 10 10 23 10 10 10 23 23 23 10 23 23 23 10 23 23 23 10 23 23 23 10 10 12
12 10 10 23 10 10 10 23 10 23 10 23 10 23 10 23 10 10 10 23 10 10 10 10 12
12 10 10 23 10 10 10 23 10 23 10 23 10 23 10 23 10 10 10 23 10 10 10 10 12
12 10 10 23 10 10 10 23 10 23 10 23 11 23 11 23 10 10 10 23 10 10 10 10 12
12 10 10 23 10 10 10 23 10 23 10 23 11 23 11 23 23 23 10 23 23 23 10 10 12
12 10 10 23 10 10 10 23 10 23 10 23 11 23 11 10 10 23 10 23 10 10 10 10 12
12 10 10 23 10 10 10 23 10 23 10 23 10 23 10 10 10 23 10 23 10 10 10 10 12
12 10 10 23 10 10 10 23 10 23 10 23 10 23 10 10 10 23 10 23 10 10 10 10 12
12 10 10 23 10 10 10 23 10 23 10 23 10 23 10 10 10 23 10 23 10 10 10 10 12
12 10 10 23 10 10 10 23 10 23 10 23 10 23 10 10 10 23 10 23 10 10 10 10 12
12 10 10 23 23 23 10 23 23 23 10 23 23 23 10 23 23 23 10 23 23 23 10 10 12
12 10 10 10 10 10 10 10 10 10 10 10 10 10 10 10 10 10 10 10 12 12 10 10 12
12 10 10 10 10 10 10 10 10 10 10 10 10 10 10 10 10 10 10 10 10 10 10 10 12
12 10 10 10 10 10 10 10 10 10 10 10 10 10 10 10 10 10 10 10 10 10 10 10 12
12 10 10 10 10 10 10 10 10 10 10 10 10 10 10 10 10 10 10 10 10 10 10 10 12
12 12 12 12 12 12 12 12 12 12 12 12 12 12 12 12 12 12 12 12 12 12 12 12 12