25 21
0 0
12 12 12 12 12 12 12 12 12 12 12 12 12 12 12 12 12 12 12 12 12 12 12 12 12
12 10 10 10 10 10 10 10 10 10 10 10 10 10 10 10 10 10 10 10 10 10 10 10 12
12 10 10 10 10 10 10 10 10 10 10 10 10 10 10 10 10 10 10 10 10 10 10 10 12
12 10 10 10 12 12 10 10 10 10 10 10 10 10 10 10 10 10 10 10 10 10 10 10 12
12 10 10 10 12 12 10 10 10 10 10 10 10 22 10 22 10 10 10 10 10 22 10 10 12
12 10 22 10 10 10 10 10 10 10 22 10 10 22 10 22 10 10 10 10 10 22 10 10 12
12 10 22 10 10 10 10 10 10 10 22 10 10 22 10 22 10 10 10 10 10 22 10 10 12
12 10 22 10 10 10 10 10 10 10 22 10 10 22 10 22 22 10 10 10 10 22 10 10 12
12 10 22 10 10 10 10 10 10 10 22 11 11 22 10 22 10 22 10 10 10 22 10 10 12
12 10 22 10 10 10 10 10 10 10 22 11 11 22 10 22 10 10 22 10 10 22 10 10 12
12 10 10 22 10 10 10 10 10 10 22 11 11 22 10 22 10 10 10 22 10 22 10 10 12
12 10 10 22 10 10 10 10 10 10 22 10 10 22 10 22 10 10 10 10 22 22 10 10 12
12 10 10 22 10 10 22 10 10 22 10 10 10 22 10 22 10 10 10 10 10 22 10 10 12
12 10 10 10 22 22 22 10 22 10 10 10 10 22 10 22 10 10 10 10 10 22 10 10 12
12 10 10 10 22 10 10 22 10 10 10 10 10 22 10 22 10 10 10 10 10 22 10 10 12
12 10 10 10 10 10 10 10 10 10 10 10 10 22 10 22 10 10 10 12 12 22 10 10 12
12 10 10 10 10 10 10 10 10 10 10 10 10 22 10 22 10 10 10 12 12 22 10 10 12
12 10 10 10 10 10 10 10 10 10 10 10 10 10 10 10 10 10 10 10 10 10 10 10 12
12 10 10 10 10 10 10 10 10 10 10 10 10 10 10 10 10 10 10 10 10 10 10 10 12
12 10 10 10 10 10 10 10 10 10 10 10 10 10 10 10 10 10 10 10 10 10 10 10 12
12 12 12 12 12 12 12 12 12 12 12 12 12 12 12 12 12 12 12 12 12 12 12 12 12
