25 21
0 0
12 12 12 12 12 12 12 12 12 12 12 12 12 12 12 12 12 12 12 12 12 12 12 12 12
12 15 15 15 15 15 15 15 15 15 15 15 15 15 15 15 15 15 15 15 15 15 15 15 12
12 15 15 15 15 15 15 15 15 15 15 15 15 15 15 15 15 15 15 15 15 15 15 15 12
12 15 15 15 15 15 15 15 15 15 15 15 15 15 15 15 15 15 15 15 15 15 15 15 12
12 15 15 15 15 15 15 15 15 15 15 15 15 15 15 15 15 15 15 15 15 15 15 15 12
12 15 15 15 22 15 15 15 15 15 22 15 22 15 22 22 15 15 15 22 15 15 15 15 12
12 15 15 15 22 15 15 15 15 15 22 15 22 15 22 22 15 15 15 22 15 15 15 15 12
12 15 15 15 22 15 15 15 15 15 22 15 22 15 22 22 22 15 15 22 15 15 15 15 12
12 15 15 15 15 15 15 15 15 22 15 15 22 15 22 15 22 15 15 22 15 15 15 15 12
12 15 15 15 15 22 15 15 15 22 15 15 22 15 22 15 22 15 15 22 15 15 15 15 12
12 15 15 15 15 22 15 15 15 22 15 15 22 15 22 15 15 22 15 22 15 15 15 15 12
12 15 15 15 15 22 15 22 15 22 15 15 22 15 22 15 15 22 15 22 15 15 15 15 12
12 15 15 15 15 22 15 22 15 22 15 15 22 15 22 15 15 22 22 22 15 15 15 15 12
12 15 15 15 15 22 15 22 15 22 15 15 22 15 22 15 15 15 22 22 15 15 15 15 12
12 15 15 15 15 15 22 15 22 15 15 15 22 15 22 15 15 15 22 22 15 15 15 15 12
12 15 15 15 15 15 22 15 22 15 15 15 22 15 22 15 15 15 15 22 15 15 15 15 12
12 15 15 15 15 15 15 15 15 15 15 15 15 15 15 15 15 15 15 15 15 15 15 15 12
12 15 15 15 15 15 15 15 15 15 15 15 15 15 15 15 15 15 15 15 15 15 15 15 12
12 15 15 15 15 15 15 15 15 15 15 15 15 15 15 15 15 15 15 15 15 15 15 15 12
12 15 15 15 15 15 15 15 15 15 15 15 15 15 15 15 15 15 15 15 15 15 15 15 12
12 12 12 12 12 12 12 12 12 12 12 12 12 12 12 12 12 12 12 12 12 12 12 12 1